s000111c01010011111100011c1101
10011111011110c11c110001111000
100110000111101110111111000111
110000110000001110011111111111
110111100110001110000110011011
11000110011111111101000c000111
1110010011001110000110001100c0
111111000011111000111111100111
110011001001100c11100001100010
111111001100011001100100001010
111100011100000011000101001011
c00001001101001110001101011011
00110011100110111101110111100c
100000111001101111c11101110111
101001110011001000111000110000
10100011010c101111100000111011
101110010110000111110011111000
10111010000001111100011101c111
000111011100111000011110110111
100111101101011100011111000101
00011011000011100011000001c101
010101000001111110000110011111
01111100001111111100011000000c
000110110010001110001110011111
0101c1111101111100111110000111
000111001110011100011111011111
000111100111100001110001111000
11010011111c000111100100c01111
c00001100101110001100111100111
11100000110000110000000111000p
