s00c000001110010c1110001111111
100111110111100000111111111000
100111110111101110111111000111
110111110000001110011111111111
110111111111111110000100000c11
110000000111111111010001111111
111001001111111000011111111111
11111100001111100011111110c111
111111001111100011111111100011
111111001111111001111100001111
111100011100000011111100111111
111001111100001111111100111111
111100111111100000011100111000
111000111001111100011100111111
1110c11100111110c01110001111c0
111001111000000001110000011100
100001111110000111110000000000
100011100000011111000111111111
100111111100111000011110111111
100111111101111111110000000111
000111111100111c00111000000111
011111000001111110000000011111
1111110c0011111111001100000000
1000000010000000000c1110011111
111111111100111100111110000111
1100000011c0011100011111000111
c00001100110001110001111000000
110000111110000111100111001111
00c000000000111111100111111111
111111111100001111c0000000000p
